*POP*
Hold the girl - Rina Sawayama
Harry's House - Harry's House
Midnights - Taylor Swift
Happier than ever - Billie Eilish
SOUR - Olivia Rodrigo
Future Nostalgia - Dua Lipa

*HIP-HOP*
This Is What I Mean - Stormzy
23 - Central Cee
Honestly, nevermind - Drake
Come home the kids miss you - Jack Harlow
The divine feminine - Mac Miller
777 - LATTO

*K-POP*
I never die - (G)I-DLE
Between 1&2 - Twice
Checkmate - ITZY
Girls - aespa
Born Pink - BLACKPINK
IM NAYEON - NAYEON

*ROCK*
OK The car - Arctic Monkeys
OK Rumours - Fleetwood Mac
OK Nevermind - Nirvana
OK The dark side of the moon - Pink Floyd
OK OK Computer - Radiohead
OK A night at the Opera - Queen

*R&B*
OK An Evening with Silk Sonic - Silk Sonic
OK Thriller - Michael Jackson
OK Gemini Rights - Steve Lacy
OK What's Going On - Marvin Gaye
OK Innervisions - Stevie Wonder
OK no thank you - Little Simz

*COUNTRY*
OK I know I'm funny Haha - Faye Webster
OK Show Pony - Orville Peck
OK Laura Stevenson - Laura Stevenson
OK The Hardest Part - Noah Cyrus
OK Saint cloud - Waxahatchee
OK Why Not Me - The Judds