*POP*
Hold the girl - Rina Sawayama
Harry's House - Harry's House
Midnights - Taylor Swift
Happier than ever - Billie Eilish
SOUR - Olivia Rodrigo
Future Nostalgia - Dua Lipa

*HIP-HOP*
This Is What I Mean - Stormzy
23 - Central Cee
Honestly, nevermind - Drake
Come home the kids miss you - Jack Harlow
The divine feminine - Mac Miller
777 - LATTO

*K-POP*
I never die - (G)I-DLE
Between 1&2 - Twice
Checkmate - ITZY
Girls - aespa
Born Pink - BLACKPINK
IM NAYEON - NAYEON

*ROCK*
The car - Arctic Monkeys
Rumours - Fleetwood Mac
Nevermind - Nirvana
The dark side of the moon - Pink Floyd
OK Computer - Radiohead
A night at the Opera - Queen

*R&B*
An Evening with Silk Sonic - Silk Sonic
Renaissance - Beyonc√©
Gemini Rights - Steve Lacy
blue water road - Kehlani
SOS - SZA
no thank you - Little Simz

*COUNTRY*
star-crossed - Kacey Musgraves
I know I'm funny Haha - Faye Webster
Show Pony - Orville Peck
Laura Stevenson - Laura Stevenson
The Hardest Part - Noah Cyrus
Saint cloud - Waxahatchee